"filename", "language", "HTML", "TypeScript", "CSS", "XML", "comment", "blank", "total"
"c:\Users\User1\Desktop\B2bProject\b2b\b2bProject\src\app\AdminArea\admin-area\admin-area.component.css", "CSS", 0, 0, 0, 0, 0, 1, 1
"c:\Users\User1\Desktop\B2bProject\b2b\b2bProject\src\app\AdminArea\admin-area\admin-area.component.html", "HTML", 12, 0, 0, 0, 0, 4, 16
"c:\Users\User1\Desktop\B2bProject\b2b\b2bProject\src\app\AdminArea\admin-area\admin-area.component.spec.ts", "TypeScript", 0, 18, 0, 0, 0, 6, 24
"c:\Users\User1\Desktop\B2bProject\b2b\b2bProject\src\app\AdminArea\admin-area\admin-area.component.ts", "TypeScript", 0, 87, 0, 0, 3, 6, 96
"c:\Users\User1\Desktop\B2bProject\b2b\b2bProject\src\app\AdminArea\admin-nav\admin-nav.component.css", "CSS", 0, 0, 59, 0, 0, 11, 70
"c:\Users\User1\Desktop\B2bProject\b2b\b2bProject\src\app\AdminArea\admin-nav\admin-nav.component.html", "HTML", 84, 0, 0, 0, 126, 18, 228
"c:\Users\User1\Desktop\B2bProject\b2b\b2bProject\src\app\AdminArea\admin-nav\admin-nav.component.spec.ts", "TypeScript", 0, 18, 0, 0, 0, 6, 24
"c:\Users\User1\Desktop\B2bProject\b2b\b2bProject\src\app\AdminArea\admin-nav\admin-nav.component.ts", "TypeScript", 0, 153, 0, 0, 1, 34, 188
"c:\Users\User1\Desktop\B2bProject\b2b\b2bProject\src\app\AdminArea\adminareaproducts\adminareaproducts.component.css", "CSS", 0, 0, 12, 0, 0, 1, 13
"c:\Users\User1\Desktop\B2bProject\b2b\b2bProject\src\app\AdminArea\adminareaproducts\adminareaproducts.component.html", "HTML", 4, 0, 0, 0, 15, 6, 25
"c:\Users\User1\Desktop\B2bProject\b2b\b2bProject\src\app\AdminArea\adminareaproducts\adminareaproducts.component.spec.ts", "TypeScript", 0, 18, 0, 0, 0, 6, 24
"c:\Users\User1\Desktop\B2bProject\b2b\b2bProject\src\app\AdminArea\adminareaproducts\adminareaproducts.component.ts", "TypeScript", 0, 60, 0, 0, 0, 12, 72
"c:\Users\User1\Desktop\B2bProject\b2b\b2bProject\src\app\AdminArea\adminareausers\adminareausers.component.css", "CSS", 0, 0, 9, 0, 0, 1, 10
"c:\Users\User1\Desktop\B2bProject\b2b\b2bProject\src\app\AdminArea\adminareausers\adminareausers.component.html", "HTML", 10, 0, 0, 0, 0, 4, 14
"c:\Users\User1\Desktop\B2bProject\b2b\b2bProject\src\app\AdminArea\adminareausers\adminareausers.component.spec.ts", "TypeScript", 0, 18, 0, 0, 0, 6, 24
"c:\Users\User1\Desktop\B2bProject\b2b\b2bProject\src\app\AdminArea\adminareausers\adminareausers.component.ts", "TypeScript", 0, 25, 0, 0, 0, 6, 31
"c:\Users\User1\Desktop\B2bProject\b2b\b2bProject\src\app\AdminArea\components\add-image-popup\add-image-popup.component.css", "CSS", 0, 0, 161, 0, 32, 31, 224
"c:\Users\User1\Desktop\B2bProject\b2b\b2bProject\src\app\AdminArea\components\add-image-popup\add-image-popup.component.html", "HTML", 48, 0, 0, 0, 20, 13, 81
"c:\Users\User1\Desktop\B2bProject\b2b\b2bProject\src\app\AdminArea\components\add-image-popup\add-image-popup.component.spec.ts", "TypeScript", 0, 18, 0, 0, 0, 6, 24
"c:\Users\User1\Desktop\B2bProject\b2b\b2bProject\src\app\AdminArea\components\add-image-popup\add-image-popup.component.ts", "TypeScript", 0, 161, 0, 0, 10, 34, 205
"c:\Users\User1\Desktop\B2bProject\b2b\b2bProject\src\app\AdminArea\components\add-image-popup\modal-service.service.spec.ts", "TypeScript", 0, 12, 0, 0, 0, 5, 17
"c:\Users\User1\Desktop\B2bProject\b2b\b2bProject\src\app\AdminArea\components\add-image-popup\modal-service.service.ts", "TypeScript", 0, 25, 0, 0, 0, 11, 36
"c:\Users\User1\Desktop\B2bProject\b2b\b2bProject\src\app\AdminArea\components\allimages\allimages.component.css", "CSS", 0, 0, 0, 0, 0, 2, 2
"c:\Users\User1\Desktop\B2bProject\b2b\b2bProject\src\app\AdminArea\components\allimages\allimages.component.html", "HTML", 11, 0, 0, 0, 0, 4, 15
"c:\Users\User1\Desktop\B2bProject\b2b\b2bProject\src\app\AdminArea\components\allimages\allimages.component.spec.ts", "TypeScript", 0, 18, 0, 0, 0, 6, 24
"c:\Users\User1\Desktop\B2bProject\b2b\b2bProject\src\app\AdminArea\components\allimages\allimages.component.ts", "TypeScript", 0, 21, 0, 0, 0, 7, 28
"c:\Users\User1\Desktop\B2bProject\b2b\b2bProject\src\app\AdminArea\components\insert-categories\insert-categories.component.css", "CSS", 0, 0, 0, 0, 0, 1, 1
"c:\Users\User1\Desktop\B2bProject\b2b\b2bProject\src\app\AdminArea\components\insert-categories\insert-categories.component.html", "HTML", 11, 0, 0, 0, 0, 1, 12
"c:\Users\User1\Desktop\B2bProject\b2b\b2bProject\src\app\AdminArea\components\insert-categories\insert-categories.component.spec.ts", "TypeScript", 0, 18, 0, 0, 0, 6, 24
"c:\Users\User1\Desktop\B2bProject\b2b\b2bProject\src\app\AdminArea\components\insert-categories\insert-categories.component.ts", "TypeScript", 0, 11, 0, 0, 0, 5, 16
"c:\Users\User1\Desktop\B2bProject\b2b\b2bProject\src\app\AdminArea\components\insert-images\insert-images.component.css", "CSS", 0, 0, 80, 0, 23, 18, 121
"c:\Users\User1\Desktop\B2bProject\b2b\b2bProject\src\app\AdminArea\components\insert-images\insert-images.component.html", "HTML", 66, 0, 0, 0, 28, 9, 103
"c:\Users\User1\Desktop\B2bProject\b2b\b2bProject\src\app\AdminArea\components\insert-images\insert-images.component.spec.ts", "TypeScript", 0, 18, 0, 0, 0, 6, 24
"c:\Users\User1\Desktop\B2bProject\b2b\b2bProject\src\app\AdminArea\components\insert-images\insert-images.component.ts", "TypeScript", 0, 142, 0, 0, 37, 22, 201
"c:\Users\User1\Desktop\B2bProject\b2b\b2bProject\src\app\AdminArea\components\insert-pdf\insert-pdf.component.css", "CSS", 0, 0, 88, 0, 23, 21, 132
"c:\Users\User1\Desktop\B2bProject\b2b\b2bProject\src\app\AdminArea\components\insert-pdf\insert-pdf.component.html", "HTML", 65, 0, 0, 0, 52, 7, 124
"c:\Users\User1\Desktop\B2bProject\b2b\b2bProject\src\app\AdminArea\components\insert-pdf\insert-pdf.component.spec.ts", "TypeScript", 0, 18, 0, 0, 0, 6, 24
"c:\Users\User1\Desktop\B2bProject\b2b\b2bProject\src\app\AdminArea\components\insert-pdf\insert-pdf.component.ts", "TypeScript", 0, 97, 0, 0, 1, 15, 113
"c:\Users\User1\Desktop\B2bProject\b2b\b2bProject\src\app\AdminArea\components\insert-products\insert-products.component.css", "CSS", 0, 0, 104, 0, 23, 30, 157
"c:\Users\User1\Desktop\B2bProject\b2b\b2bProject\src\app\AdminArea\components\insert-products\insert-products.component.html", "HTML", 136, 0, 0, 0, 130, 10, 276
"c:\Users\User1\Desktop\B2bProject\b2b\b2bProject\src\app\AdminArea\components\insert-products\insert-products.component.spec.ts", "TypeScript", 0, 18, 0, 0, 0, 6, 24
"c:\Users\User1\Desktop\B2bProject\b2b\b2bProject\src\app\AdminArea\components\insert-products\insert-products.component.ts", "TypeScript", 0, 172, 0, 0, 26, 42, 240
"c:\Users\User1\Desktop\B2bProject\b2b\b2bProject\src\app\AdminArea\components\offer-popup\offer-popup.component.css", "CSS", 0, 0, 22, 0, 0, 7, 29
"c:\Users\User1\Desktop\B2bProject\b2b\b2bProject\src\app\AdminArea\components\offer-popup\offer-popup.component.html", "HTML", 47, 0, 0, 0, 16, 6, 69
"c:\Users\User1\Desktop\B2bProject\b2b\b2bProject\src\app\AdminArea\components\offer-popup\offer-popup.component.spec.ts", "TypeScript", 0, 18, 0, 0, 0, 6, 24
"c:\Users\User1\Desktop\B2bProject\b2b\b2bProject\src\app\AdminArea\components\offer-popup\offer-popup.component.ts", "TypeScript", 0, 25, 0, 0, 0, 7, 32
"c:\Users\User1\Desktop\B2bProject\b2b\b2bProject\src\app\AdminArea\components\pop-up-login\pop-up-login.component.css", "CSS", 0, 0, 50, 0, 0, 10, 60
"c:\Users\User1\Desktop\B2bProject\b2b\b2bProject\src\app\AdminArea\components\pop-up-login\pop-up-login.component.html", "HTML", 39, 0, 0, 0, 1, 1, 41
"c:\Users\User1\Desktop\B2bProject\b2b\b2bProject\src\app\AdminArea\components\pop-up-login\pop-up-login.component.spec.ts", "TypeScript", 0, 18, 0, 0, 0, 6, 24
"c:\Users\User1\Desktop\B2bProject\b2b\b2bProject\src\app\AdminArea\components\pop-up-login\pop-up-login.component.ts", "TypeScript", 0, 125, 0, 0, 3, 13, 141
"c:\Users\User1\Desktop\B2bProject\b2b\b2bProject\src\app\AdminArea\components\searchbar\searchbar.component.css", "CSS", 0, 0, 7, 0, 0, 5, 12
"c:\Users\User1\Desktop\B2bProject\b2b\b2bProject\src\app\AdminArea\components\searchbar\searchbar.component.html", "HTML", 9, 0, 0, 0, 0, 3, 12
"c:\Users\User1\Desktop\B2bProject\b2b\b2bProject\src\app\AdminArea\components\searchbar\searchbar.component.spec.ts", "TypeScript", 0, 18, 0, 0, 0, 6, 24
"c:\Users\User1\Desktop\B2bProject\b2b\b2bProject\src\app\AdminArea\components\searchbar\searchbar.component.ts", "TypeScript", 0, 47, 0, 0, 0, 9, 56
"c:\Users\User1\Desktop\B2bProject\b2b\b2bProject\src\app\AdminArea\components\update-categories\update-categories.component.css", "CSS", 0, 0, 6, 0, 0, 2, 8
"c:\Users\User1\Desktop\B2bProject\b2b\b2bProject\src\app\AdminArea\components\update-categories\update-categories.component.html", "HTML", 14, 0, 0, 0, 0, 1, 15
"c:\Users\User1\Desktop\B2bProject\b2b\b2bProject\src\app\AdminArea\components\update-categories\update-categories.component.spec.ts", "TypeScript", 0, 18, 0, 0, 0, 6, 24
"c:\Users\User1\Desktop\B2bProject\b2b\b2bProject\src\app\AdminArea\components\update-categories\update-categories.component.ts", "TypeScript", 0, 11, 0, 0, 0, 5, 16
"c:\Users\User1\Desktop\B2bProject\b2b\b2bProject\src\app\AdminArea\components\update-colors\update-colors.component.css", "CSS", 0, 0, 4, 0, 0, 0, 4
"c:\Users\User1\Desktop\B2bProject\b2b\b2bProject\src\app\AdminArea\components\update-colors\update-colors.component.html", "HTML", 15, 0, 0, 0, 8, 4, 27
"c:\Users\User1\Desktop\B2bProject\b2b\b2bProject\src\app\AdminArea\components\update-colors\update-colors.component.spec.ts", "TypeScript", 0, 18, 0, 0, 0, 6, 24
"c:\Users\User1\Desktop\B2bProject\b2b\b2bProject\src\app\AdminArea\components\update-colors\update-colors.component.ts", "TypeScript", 0, 11, 0, 0, 0, 5, 16
"c:\Users\User1\Desktop\B2bProject\b2b\b2bProject\src\app\AdminArea\components\upload-image\upload-image.component.css", "CSS", 0, 0, 52, 0, 0, 10, 62
"c:\Users\User1\Desktop\B2bProject\b2b\b2bProject\src\app\AdminArea\components\upload-image\upload-image.component.html", "HTML", 23, 0, 0, 0, 21, 3, 47
"c:\Users\User1\Desktop\B2bProject\b2b\b2bProject\src\app\AdminArea\components\upload-image\upload-image.component.spec.ts", "TypeScript", 0, 18, 0, 0, 0, 6, 24
"c:\Users\User1\Desktop\B2bProject\b2b\b2bProject\src\app\AdminArea\components\upload-image\upload-image.component.ts", "TypeScript", 0, 65, 0, 0, 24, 24, 113
"c:\Users\User1\Desktop\B2bProject\b2b\b2bProject\src\app\AdminArea\components\upload-image\upload-image.service.spec.ts", "TypeScript", 0, 12, 0, 0, 0, 5, 17
"c:\Users\User1\Desktop\B2bProject\b2b\b2bProject\src\app\AdminArea\components\upload-image\upload-image.service.ts", "TypeScript", 0, 23, 0, 0, 0, 8, 31
"c:\Users\User1\Desktop\B2bProject\b2b\b2bProject\src\app\AdminArea\components\upload-pdf\upload-pdf.component.css", "CSS", 0, 0, 52, 0, 0, 10, 62
"c:\Users\User1\Desktop\B2bProject\b2b\b2bProject\src\app\AdminArea\components\upload-pdf\upload-pdf.component.html", "HTML", 23, 0, 0, 0, 10, 3, 36
"c:\Users\User1\Desktop\B2bProject\b2b\b2bProject\src\app\AdminArea\components\upload-pdf\upload-pdf.component.spec.ts", "TypeScript", 0, 18, 0, 0, 0, 6, 24
"c:\Users\User1\Desktop\B2bProject\b2b\b2bProject\src\app\AdminArea\components\upload-pdf\upload-pdf.component.ts", "TypeScript", 0, 53, 0, 0, 0, 17, 70
"c:\Users\User1\Desktop\B2bProject\b2b\b2bProject\src\app\AdminArea\components\upload-pdf\upload-pdf.service.spec.ts", "TypeScript", 0, 12, 0, 0, 0, 5, 17
"c:\Users\User1\Desktop\B2bProject\b2b\b2bProject\src\app\AdminArea\components\upload-pdf\upload-pdf.service.ts", "TypeScript", 0, 17, 0, 0, 0, 7, 24
"c:\Users\User1\Desktop\B2bProject\b2b\b2bProject\src\app\AdminArea\image\image.component.css", "CSS", 0, 0, 53, 0, 3, 12, 68
"c:\Users\User1\Desktop\B2bProject\b2b\b2bProject\src\app\AdminArea\image\image.component.html", "HTML", 31, 0, 0, 0, 0, 3, 34
"c:\Users\User1\Desktop\B2bProject\b2b\b2bProject\src\app\AdminArea\image\image.component.spec.ts", "TypeScript", 0, 18, 0, 0, 0, 6, 24
"c:\Users\User1\Desktop\B2bProject\b2b\b2bProject\src\app\AdminArea\image\image.component.ts", "TypeScript", 0, 11, 0, 0, 0, 5, 16
"c:\Users\User1\Desktop\B2bProject\b2b\b2bProject\src\app\AdminArea\pdf-component\pdf-component.component.css", "CSS", 0, 0, 53, 0, 3, 12, 68
"c:\Users\User1\Desktop\B2bProject\b2b\b2bProject\src\app\AdminArea\pdf-component\pdf-component.component.html", "HTML", 31, 0, 0, 0, 0, 3, 34
"c:\Users\User1\Desktop\B2bProject\b2b\b2bProject\src\app\AdminArea\pdf-component\pdf-component.component.spec.ts", "TypeScript", 0, 18, 0, 0, 0, 6, 24
"c:\Users\User1\Desktop\B2bProject\b2b\b2bProject\src\app\AdminArea\pdf-component\pdf-component.component.ts", "TypeScript", 0, 11, 0, 0, 0, 5, 16
"c:\Users\User1\Desktop\B2bProject\b2b\b2bProject\src\app\app-routing.module.ts", "TypeScript", 0, 176, 0, 0, 0, 11, 187
"c:\Users\User1\Desktop\B2bProject\b2b\b2bProject\src\app\app.component.css", "CSS", 0, 0, 189, 0, 29, 35, 253
"c:\Users\User1\Desktop\B2bProject\b2b\b2bProject\src\app\app.component.html", "HTML", 79, 0, 0, 0, 15, 15, 109
"c:\Users\User1\Desktop\B2bProject\b2b\b2bProject\src\app\app.component.spec.ts", "TypeScript", 0, 27, 0, 0, 0, 5, 32
"c:\Users\User1\Desktop\B2bProject\b2b\b2bProject\src\app\app.component.ts", "TypeScript", 0, 237, 0, 0, 15, 98, 350
"c:\Users\User1\Desktop\B2bProject\b2b\b2bProject\src\app\app.module.ts", "TypeScript", 0, 155, 0, 0, 2, 36, 193
"c:\Users\User1\Desktop\B2bProject\b2b\b2bProject\src\app\cart\cart-item\cart-item.component.css", "CSS", 0, 0, 141, 0, 0, 29, 170
"c:\Users\User1\Desktop\B2bProject\b2b\b2bProject\src\app\cart\cart-item\cart-item.component.html", "HTML", 16, 0, 0, 0, 0, 1, 17
"c:\Users\User1\Desktop\B2bProject\b2b\b2bProject\src\app\cart\cart-item\cart-item.component.spec.ts", "TypeScript", 0, 18, 0, 0, 0, 6, 24
"c:\Users\User1\Desktop\B2bProject\b2b\b2bProject\src\app\cart\cart-item\cart-item.component.ts", "TypeScript", 0, 22, 0, 0, 0, 11, 33
"c:\Users\User1\Desktop\B2bProject\b2b\b2bProject\src\app\cart\cart-service.service.spec.ts", "TypeScript", 0, 12, 0, 0, 0, 5, 17
"c:\Users\User1\Desktop\B2bProject\b2b\b2bProject\src\app\cart\cart-service.service.ts", "TypeScript", 0, 207, 0, 0, 12, 62, 281
"c:\Users\User1\Desktop\B2bProject\b2b\b2bProject\src\app\cart\cart.component.css", "CSS", 0, 0, 339, 0, 2, 65, 406
"c:\Users\User1\Desktop\B2bProject\b2b\b2bProject\src\app\cart\cart.component.html", "HTML", 157, 0, 0, 0, 74, 20, 251
"c:\Users\User1\Desktop\B2bProject\b2b\b2bProject\src\app\cart\cart.component.spec.ts", "TypeScript", 0, 18, 0, 0, 0, 6, 24
"c:\Users\User1\Desktop\B2bProject\b2b\b2bProject\src\app\cart\cart.component.ts", "TypeScript", 0, 270, 0, 0, 12, 105, 387
"c:\Users\User1\Desktop\B2bProject\b2b\b2bProject\src\app\cart\favorite\favorite.component.css", "CSS", 0, 0, 285, 0, 0, 33, 318
"c:\Users\User1\Desktop\B2bProject\b2b\b2bProject\src\app\cart\favorite\favorite.component.html", "HTML", 46, 0, 0, 0, 51, 3, 100
"c:\Users\User1\Desktop\B2bProject\b2b\b2bProject\src\app\cart\favorite\favorite.component.spec.ts", "TypeScript", 0, 18, 0, 0, 0, 6, 24
"c:\Users\User1\Desktop\B2bProject\b2b\b2bProject\src\app\cart\favorite\favorite.component.ts", "TypeScript", 0, 69, 0, 0, 2, 13, 84
"c:\Users\User1\Desktop\B2bProject\b2b\b2bProject\src\app\checkout-nav\checkout-nav.component.css", "CSS", 0, 0, 42, 0, 0, 9, 51
"c:\Users\User1\Desktop\B2bProject\b2b\b2bProject\src\app\checkout-nav\checkout-nav.component.html", "HTML", 36, 0, 0, 0, 0, 4, 40
"c:\Users\User1\Desktop\B2bProject\b2b\b2bProject\src\app\checkout-nav\checkout-nav.component.spec.ts", "TypeScript", 0, 18, 0, 0, 0, 6, 24
"c:\Users\User1\Desktop\B2bProject\b2b\b2bProject\src\app\checkout-nav\checkout-nav.component.ts", "TypeScript", 0, 11, 0, 0, 0, 5, 16
"c:\Users\User1\Desktop\B2bProject\b2b\b2bProject\src\app\checkout-page\checkout-page.component.css", "CSS", 0, 0, 152, 0, 11, 44, 207
"c:\Users\User1\Desktop\B2bProject\b2b\b2bProject\src\app\checkout-page\checkout-page.component.html", "HTML", 144, 0, 0, 0, 112, 12, 268
"c:\Users\User1\Desktop\B2bProject\b2b\b2bProject\src\app\checkout-page\checkout-page.component.spec.ts", "TypeScript", 0, 18, 0, 0, 0, 6, 24
"c:\Users\User1\Desktop\B2bProject\b2b\b2bProject\src\app\checkout-page\checkout-page.component.ts", "TypeScript", 0, 308, 0, 0, 13, 67, 388
"c:\Users\User1\Desktop\B2bProject\b2b\b2bProject\src\app\footer\footer.component.css", "CSS", 0, 0, 92, 0, 0, 21, 113
"c:\Users\User1\Desktop\B2bProject\b2b\b2bProject\src\app\footer\footer.component.html", "HTML", 598, 0, 0, 0, 0, 5, 603
"c:\Users\User1\Desktop\B2bProject\b2b\b2bProject\src\app\footer\footer.component.spec.ts", "TypeScript", 0, 18, 0, 0, 0, 6, 24
"c:\Users\User1\Desktop\B2bProject\b2b\b2bProject\src\app\footer\footer.component.ts", "TypeScript", 0, 12, 0, 0, 0, 4, 16
"c:\Users\User1\Desktop\B2bProject\b2b\b2bProject\src\app\homepage\homepage.component.css", "CSS", 0, 0, 632, 0, 22, 152, 806
"c:\Users\User1\Desktop\B2bProject\b2b\b2bProject\src\app\homepage\homepage.component.html", "HTML", 151, 0, 0, 0, 60, 53, 264
"c:\Users\User1\Desktop\B2bProject\b2b\b2bProject\src\app\homepage\homepage.component.spec.ts", "TypeScript", 0, 18, 0, 0, 0, 6, 24
"c:\Users\User1\Desktop\B2bProject\b2b\b2bProject\src\app\homepage\homepage.component.ts", "TypeScript", 0, 81, 0, 0, 2, 31, 114
"c:\Users\User1\Desktop\B2bProject\b2b\b2bProject\src\app\log-in\log-in.component.css", "CSS", 0, 0, 67, 0, 0, 18, 85
"c:\Users\User1\Desktop\B2bProject\b2b\b2bProject\src\app\log-in\log-in.component.html", "HTML", 42, 0, 0, 0, 49, 15, 106
"c:\Users\User1\Desktop\B2bProject\b2b\b2bProject\src\app\log-in\log-in.component.spec.ts", "TypeScript", 0, 18, 0, 0, 0, 6, 24
"c:\Users\User1\Desktop\B2bProject\b2b\b2bProject\src\app\log-in\log-in.component.ts", "TypeScript", 0, 81, 0, 0, 16, 27, 124
"c:\Users\User1\Desktop\B2bProject\b2b\b2bProject\src\app\my-orders\my-orders.component.css", "CSS", 0, 0, 111, 0, 6, 27, 144
"c:\Users\User1\Desktop\B2bProject\b2b\b2bProject\src\app\my-orders\my-orders.component.html", "HTML", 170, 0, 0, 0, 0, 23, 193
"c:\Users\User1\Desktop\B2bProject\b2b\b2bProject\src\app\my-orders\my-orders.component.spec.ts", "TypeScript", 0, 18, 0, 0, 0, 6, 24
"c:\Users\User1\Desktop\B2bProject\b2b\b2bProject\src\app\my-orders\my-orders.component.ts", "TypeScript", 0, 60, 0, 0, 0, 12, 72
"c:\Users\User1\Desktop\B2bProject\b2b\b2bProject\src\app\navbar\navbar.component.css", "CSS", 0, 0, 333, 0, 26, 92, 451
"c:\Users\User1\Desktop\B2bProject\b2b\b2bProject\src\app\navbar\navbar.component.html", "HTML", 337, 0, 0, 0, 89, 30, 456
"c:\Users\User1\Desktop\B2bProject\b2b\b2bProject\src\app\navbar\navbar.component.spec.ts", "TypeScript", 0, 18, 0, 0, 0, 6, 24
"c:\Users\User1\Desktop\B2bProject\b2b\b2bProject\src\app\navbar\navbar.component.ts", "TypeScript", 0, 297, 0, 0, 22, 111, 430
"c:\Users\User1\Desktop\B2bProject\b2b\b2bProject\src\app\next.directive.spec.ts", "TypeScript", 0, 7, 0, 0, 0, 2, 9
"c:\Users\User1\Desktop\B2bProject\b2b\b2bProject\src\app\next.directive.ts", "TypeScript", 0, 14, 0, 0, 0, 13, 27
"c:\Users\User1\Desktop\B2bProject\b2b\b2bProject\src\app\order-completed\order-completed.component.css", "CSS", 0, 0, 105, 0, 0, 14, 119
"c:\Users\User1\Desktop\B2bProject\b2b\b2bProject\src\app\order-completed\order-completed.component.html", "HTML", 32, 0, 0, 0, 0, 2, 34
"c:\Users\User1\Desktop\B2bProject\b2b\b2bProject\src\app\order-completed\order-completed.component.spec.ts", "TypeScript", 0, 18, 0, 0, 0, 6, 24
"c:\Users\User1\Desktop\B2bProject\b2b\b2bProject\src\app\order-completed\order-completed.component.ts", "TypeScript", 0, 23, 0, 0, 0, 9, 32
"c:\Users\User1\Desktop\B2bProject\b2b\b2bProject\src\app\page-not-found\page-not-found.component.css", "CSS", 0, 0, 24, 0, 0, 4, 28
"c:\Users\User1\Desktop\B2bProject\b2b\b2bProject\src\app\page-not-found\page-not-found.component.html", "HTML", 16, 0, 0, 0, 0, 2, 18
"c:\Users\User1\Desktop\B2bProject\b2b\b2bProject\src\app\page-not-found\page-not-found.component.spec.ts", "TypeScript", 0, 18, 0, 0, 0, 6, 24
"c:\Users\User1\Desktop\B2bProject\b2b\b2bProject\src\app\page-not-found\page-not-found.component.ts", "TypeScript", 0, 19, 0, 0, 0, 9, 28
"c:\Users\User1\Desktop\B2bProject\b2b\b2bProject\src\app\porducts\categories.model.ts", "TypeScript", 0, 3, 0, 0, 0, 1, 4
"c:\Users\User1\Desktop\B2bProject\b2b\b2bProject\src\app\porducts\mosqui-wizzard\mosqui-wizzard.component.css", "CSS", 0, 0, 189, 0, 1, 30, 220
"c:\Users\User1\Desktop\B2bProject\b2b\b2bProject\src\app\porducts\mosqui-wizzard\mosqui-wizzard.component.html", "HTML", 96, 0, 0, 0, 135, 21, 252
"c:\Users\User1\Desktop\B2bProject\b2b\b2bProject\src\app\porducts\mosqui-wizzard\mosqui-wizzard.component.spec.ts", "TypeScript", 0, 18, 0, 0, 0, 6, 24
"c:\Users\User1\Desktop\B2bProject\b2b\b2bProject\src\app\porducts\mosqui-wizzard\mosqui-wizzard.component.ts", "TypeScript", 0, 132, 0, 0, 2, 26, 160
"c:\Users\User1\Desktop\B2bProject\b2b\b2bProject\src\app\porducts\porducts.component.css", "CSS", 0, 0, 13, 0, 0, 7, 20
"c:\Users\User1\Desktop\B2bProject\b2b\b2bProject\src\app\porducts\porducts.component.html", "HTML", 5, 0, 0, 0, 0, 10, 15
"c:\Users\User1\Desktop\B2bProject\b2b\b2bProject\src\app\porducts\porducts.component.spec.ts", "TypeScript", 0, 18, 0, 0, 0, 6, 24
"c:\Users\User1\Desktop\B2bProject\b2b\b2bProject\src\app\porducts\porducts.component.ts", "TypeScript", 0, 50, 0, 0, 0, 15, 65
"c:\Users\User1\Desktop\B2bProject\b2b\b2bProject\src\app\porducts\product-list\PerlaProfilLogo-dark 1.svg", "XML", 0, 0, 0, 8, 0, 1, 9
"c:\Users\User1\Desktop\B2bProject\b2b\b2bProject\src\app\porducts\product-list\product-list.component.css", "CSS", 0, 0, 1079, 0, 84, 256, 1419
"c:\Users\User1\Desktop\B2bProject\b2b\b2bProject\src\app\porducts\product-list\product-list.component.html", "HTML", 345, 0, 0, 0, 69, 42, 456
"c:\Users\User1\Desktop\B2bProject\b2b\b2bProject\src\app\porducts\product-list\product-list.component.spec.ts", "TypeScript", 0, 18, 0, 0, 0, 6, 24
"c:\Users\User1\Desktop\B2bProject\b2b\b2bProject\src\app\porducts\product-list\product-list.component.ts", "TypeScript", 0, 849, 0, 0, 64, 185, 1098
"c:\Users\User1\Desktop\B2bProject\b2b\b2bProject\src\app\porducts\product-page\product-page.component.css", "CSS", 0, 0, 530, 0, 18, 71, 619
"c:\Users\User1\Desktop\B2bProject\b2b\b2bProject\src\app\porducts\product-page\product-page.component.html", "HTML", 307, 0, 0, 0, 4, 43, 354
"c:\Users\User1\Desktop\B2bProject\b2b\b2bProject\src\app\porducts\product-page\product-page.component.ts", "TypeScript", 0, 537, 0, 0, 5, 73, 615
"c:\Users\User1\Desktop\B2bProject\b2b\b2bProject\src\app\porducts\product-page\safe-pipe.pipe.spec.ts", "TypeScript", 0, 7, 0, 0, 0, 2, 9
"c:\Users\User1\Desktop\B2bProject\b2b\b2bProject\src\app\porducts\product-page\safe-pipe.pipe.ts", "TypeScript", 0, 11, 0, 0, 0, 2, 13
"c:\Users\User1\Desktop\B2bProject\b2b\b2bProject\src\app\porducts\products-carousel\products-carousel.component.css", "CSS", 0, 0, 11, 0, 0, 1, 12
"c:\Users\User1\Desktop\B2bProject\b2b\b2bProject\src\app\porducts\products-carousel\products-carousel.component.html", "HTML", 32, 0, 0, 0, 126, 4, 162
"c:\Users\User1\Desktop\B2bProject\b2b\b2bProject\src\app\porducts\products-carousel\products-carousel.component.spec.ts", "TypeScript", 0, 18, 0, 0, 0, 6, 24
"c:\Users\User1\Desktop\B2bProject\b2b\b2bProject\src\app\porducts\products-carousel\products-carousel.component.ts", "TypeScript", 0, 90, 0, 0, 8, 19, 117
"c:\Users\User1\Desktop\B2bProject\b2b\b2bProject\src\app\porducts\products.service.ts", "TypeScript", 0, 90, 0, 0, 2, 35, 127
"c:\Users\User1\Desktop\B2bProject\b2b\b2bProject\src\app\porducts\single-product\single-product.component.css", "CSS", 0, 0, 627, 0, 6, 113, 746
"c:\Users\User1\Desktop\B2bProject\b2b\b2bProject\src\app\porducts\single-product\single-product.component.html", "HTML", 30, 0, 0, 0, 120, 19, 169
"c:\Users\User1\Desktop\B2bProject\b2b\b2bProject\src\app\porducts\single-product\single-product.component.spec.ts", "TypeScript", 0, 18, 0, 0, 0, 6, 24
"c:\Users\User1\Desktop\B2bProject\b2b\b2bProject\src\app\porducts\single-product\single-product.component.ts", "TypeScript", 0, 191, 0, 0, 1, 65, 257
"c:\Users\User1\Desktop\B2bProject\b2b\b2bProject\src\app\prev.directive.spec.ts", "TypeScript", 0, 7, 0, 0, 0, 2, 9
"c:\Users\User1\Desktop\B2bProject\b2b\b2bProject\src\app\prev.directive.ts", "TypeScript", 0, 13, 0, 0, 0, 7, 20
"c:\Users\User1\Desktop\B2bProject\b2b\b2bProject\src\app\profile\profile.component.css", "CSS", 0, 0, 0, 0, 0, 1, 1
"c:\Users\User1\Desktop\B2bProject\b2b\b2bProject\src\app\profile\profile.component.html", "HTML", 3, 0, 0, 0, 0, 2, 5
"c:\Users\User1\Desktop\B2bProject\b2b\b2bProject\src\app\profile\profile.component.spec.ts", "TypeScript", 0, 18, 0, 0, 0, 6, 24
"c:\Users\User1\Desktop\B2bProject\b2b\b2bProject\src\app\profile\profile.component.ts", "TypeScript", 0, 26, 0, 0, 0, 6, 32
"c:\Users\User1\Desktop\B2bProject\b2b\b2bProject\src\app\services\admin.guard.spec.ts", "TypeScript", 0, 12, 0, 0, 0, 5, 17
"c:\Users\User1\Desktop\B2bProject\b2b\b2bProject\src\app\services\admin.guard.ts", "TypeScript", 0, 27, 0, 0, 5, 6, 38
"c:\Users\User1\Desktop\B2bProject\b2b\b2bProject\src\app\services\auth-interceptor.service.ts", "TypeScript", 0, 20, 0, 0, 0, 4, 24
"c:\Users\User1\Desktop\B2bProject\b2b\b2bProject\src\app\services\auth.guard.ts", "TypeScript", 0, 28, 0, 0, 5, 5, 38
"c:\Users\User1\Desktop\B2bProject\b2b\b2bProject\src\app\services\auth.service.spec.ts", "TypeScript", 0, 12, 0, 0, 0, 5, 17
"c:\Users\User1\Desktop\B2bProject\b2b\b2bProject\src\app\services\auth.service.ts", "TypeScript", 0, 161, 0, 0, 3, 52, 216
"c:\Users\User1\Desktop\B2bProject\b2b\b2bProject\src\app\services\translate-config.service.ts", "TypeScript", 0, 23, 0, 0, 0, 6, 29
"c:\Users\User1\Desktop\B2bProject\b2b\b2bProject\src\app\services\user.model.ts", "TypeScript", 0, 9, 0, 0, 3, 4, 16
"c:\Users\User1\Desktop\B2bProject\b2b\b2bProject\src\app\shared\contact-model.ts", "TypeScript", 0, 5, 0, 0, 0, 1, 6
"c:\Users\User1\Desktop\B2bProject\b2b\b2bProject\src\app\shared\contatc-form\contatc-form.component.css", "CSS", 0, 0, 33, 0, 0, 6, 39
"c:\Users\User1\Desktop\B2bProject\b2b\b2bProject\src\app\shared\contatc-form\contatc-form.component.html", "HTML", 93, 0, 0, 0, 95, 5, 193
"c:\Users\User1\Desktop\B2bProject\b2b\b2bProject\src\app\shared\contatc-form\contatc-form.component.spec.ts", "TypeScript", 0, 18, 0, 0, 0, 6, 24
"c:\Users\User1\Desktop\B2bProject\b2b\b2bProject\src\app\shared\contatc-form\contatc-form.component.ts", "TypeScript", 0, 56, 0, 0, 0, 14, 70
"c:\Users\User1\Desktop\B2bProject\b2b\b2bProject\src\app\shared\product-added-to-cart\checkout.guard.ts", "TypeScript", 0, 28, 0, 0, 0, 2, 30
"c:\Users\User1\Desktop\B2bProject\b2b\b2bProject\src\app\shared\product-added-to-cart\product-added-to-cart.component.css", "CSS", 0, 0, 0, 0, 0, 1, 1
"c:\Users\User1\Desktop\B2bProject\b2b\b2bProject\src\app\shared\product-added-to-cart\product-added-to-cart.component.html", "HTML", 1, 0, 0, 0, 0, 1, 2
"c:\Users\User1\Desktop\B2bProject\b2b\b2bProject\src\app\shared\product-added-to-cart\product-added-to-cart.component.spec.ts", "TypeScript", 0, 18, 0, 0, 0, 6, 24
"c:\Users\User1\Desktop\B2bProject\b2b\b2bProject\src\app\shared\product-added-to-cart\product-added-to-cart.component.ts", "TypeScript", 0, 12, 0, 0, 0, 6, 18
"c:\Users\User1\Desktop\B2bProject\b2b\b2bProject\src\app\spinner\spinner.component.css", "CSS", 0, 0, 80, 0, 1, 1, 82
"c:\Users\User1\Desktop\B2bProject\b2b\b2bProject\src\app\spinner\spinner.component.html", "HTML", 1, 0, 0, 0, 0, 1, 2
"c:\Users\User1\Desktop\B2bProject\b2b\b2bProject\src\app\spinner\spinner.component.spec.ts", "TypeScript", 0, 18, 0, 0, 0, 6, 24
"c:\Users\User1\Desktop\B2bProject\b2b\b2bProject\src\app\spinner\spinner.component.ts", "TypeScript", 0, 11, 0, 0, 0, 5, 16
"c:\Users\User1\Desktop\B2bProject\b2b\b2bProject\src\app\team\team.component.css", "CSS", 0, 0, 38, 0, 0, 8, 46
"c:\Users\User1\Desktop\B2bProject\b2b\b2bProject\src\app\team\team.component.html", "HTML", 61, 0, 0, 0, 0, 9, 70
"c:\Users\User1\Desktop\B2bProject\b2b\b2bProject\src\app\team\team.component.spec.ts", "TypeScript", 0, 18, 0, 0, 0, 6, 24
"c:\Users\User1\Desktop\B2bProject\b2b\b2bProject\src\app\team\team.component.ts", "TypeScript", 0, 100, 0, 0, 12, 12, 124
"c:\Users\User1\Desktop\B2bProject\b2b\b2bProject\src\app\the-company\the-company.component.css", "CSS", 0, 0, 70, 0, 5, 15, 90
"c:\Users\User1\Desktop\B2bProject\b2b\b2bProject\src\app\the-company\the-company.component.html", "HTML", 66, 0, 0, 0, 0, 12, 78
"c:\Users\User1\Desktop\B2bProject\b2b\b2bProject\src\app\the-company\the-company.component.spec.ts", "TypeScript", 0, 18, 0, 0, 0, 6, 24
"c:\Users\User1\Desktop\B2bProject\b2b\b2bProject\src\app\the-company\the-company.component.ts", "TypeScript", 0, 107, 0, 0, 0, 29, 136
"Total", "-", 3543, 6850, 5994, 8, 2055, 3492, 21942